_______________________________________________________________________________________________
_____________e_____e_____e_____e_____e_____e_____e_____e_____e_____e_____e_____e_____e_____e___
_______________________________________________________________________________________________
_________________c_c_c___________c_c_c___________c_c_c___________c_c_c___________c_c_c_________
_______________________________________________________________________________________________
_____________e_____e_____e_____e_____e_____e_____e_____e_____e_____e_____e_____e_____e_____e___
_______________________________________________________________________________________________
_________________c_c_c___________c_c_c___________c_c_c___________c_c_c___________c_c_c_________
_______________________________________________________________________________________________
_____________e_____e_____e_____e_____e_____e_____e_____e_____e_____e_____e_____e_____e_____e___