_______________________________________________________________________________________________
_______________________________________________________________________________________________
__________e_______c_c_c_______e_______c_c_c_______e_______c_c_c_______e_______c_c_c_______e____
_______________________________________________________________________________________________
______________e_______c_c_c_______e_______c_c_c_______e_______c_c_c_______e_______c_c_c________
_______________________________________________________________________________________________
__________________e_______c_c_c_______e_______c_c_c_______e_______c_c_c_______e_______c_c_c____
_______________________________________________________________________________________________
__________e_______c_c_c_______e_______c_c_c_______e_______c_c_c_______e_______c_c_c_______e____
_______________________________________________________________________________________________