_______________________________________________________________________________________________
_______________________________________________________________________________________________
____________e___e___e___e___e___e___e___e___e___e___e___e___e___e___e___e___e___e___e___e______
_______________________________________________________________________________________________
_______________________________________________________________________________________________
________________c_c_c___________c_c_c___________c_c_c___________c_c_c___________c_c_c__________
_______________________________________________________________________________________________
_______________________________________________________________________________________________
____________e___e___e___e___e___e___e___e___e___e___e___e___e___e___e___e___e___e___e___e______
_______________________________________________________________________________________________